[일상 회화] 공항	airport	일상 회화	airport.webp
[일상 회화] 식당	restaurant	일상 회화	restaurant.webp
[일상 회화] 슈퍼마켓	supermarket	일상 회화	supermarket.webp
[일상 회화] 호텔	hotel	일상 회화	hotel.webp
[일상 회화] 병원	hospital	일상 회화	hospital.webp
[일상 회화] 약국	pharmacy	일상 회화	pharmacy.webp
[일상 회화] 은행	bank	일상 회화	bank.webp
[일상 회화] 우체국	post_office	일상 회화	post_office.webp
[일상 회화] 기차역	station	일상 회화	station.webp
[일상 회화] 버스정류장	bus_stop	일상 회화	bus_stop.webp
[일상 회화] 학교	school	일상 회화	school.webp
[일상 회화] 사무실	office	일상 회화	office.webp
[일상 회화] 집	home	일상 회화	home.webp
[일상 회화] 헬스장	gym	일상 회화	gym.webp
[일상 회화] 공원	park	일상 회화	park.webp
[일상 회화] 쇼핑몰	mall	일상 회화	mall.webp
[일상 회화] 영화관	cinema	일상 회화	cinema.webp
[일상 회화] 도서관	library	일상 회화	library.webp
[일상 회화] 커피숍	cafe	일상 회화	cafe.webp
[일상 회화] 경찰서	police_station	일상 회화	police_station.webp
[일상 회화] 주유소	gas_station	일상 회화	gas_station.webp
[일상 회화] 미용실	salon	일상 회화	salon.webp
[일상 회화] 세탁소	laundromat	일상 회화	laundromat.webp
[일상 회화] 식료품점	grocery	일상 회화	grocery.webp
[일상 회화] 치과	dentist	일상 회화	dentist.webp
[일상 회화] 정비소	garage	일상 회화	garage.webp
[일상 회화] 동물병원	veterinary	일상 회화	veterinary.webp
[일상 회화] 서점	bookstore	일상 회화	bookstore.webp
[일상 회화] 미술관	art_gallery	일상 회화	art_gallery.webp
[일상 회화] 박물관	museum	일상 회화	museum.webp
[일상 회화] 공연장	theater	일상 회화	theater.webp
[일상 회화] 놀이공원	amusement_park	일상 회화	amusement_park.webp
[일상 회화] 수영장	pool	일상 회화	pool.webp
[일상 회화] 해변	beach	일상 회화	beach.webp
[일상 회화] 캠핑장	campsite	일상 회화	campsite.webp
[일상 회화] 교회	church	일상 회화	church.webp
[일상 회화] ATM	atm	일상 회화	atm.webp
[일상 회화] 시장	market	일상 회화	market.webp
[일상 회화] 노래방	karaoke	일상 회화	karaoke.webp
[일상 회화] 사진관	photo_studio	일상 회화	photo_studio.webp
[일상 회화] 이케아	IKEA	일상 회화	IKEA.webp
[일상 회화] 패스트푸드점	fast_food	일상 회화	fast_food.webp
[일상 회화] 펫샵	pet_store	일상 회화	pet_store.webp
[일상 회화] 휴게소	rest_area	일상 회화	rest_area.webp
[일상 회화] 안과	eye_clinic	일상 회화	eye_clinic.webp
[일상 회화] 경기장	stadium	일상 회화	stadium.webp
[일상 회화] 세차장	car_wash	일상 회화	car_wash.webp
[일상 회화] 유치원	kindergarten	일상 회화	kindergarten.webp
[일상 회화] 대학교	university	일상 회화	university.webp
[일상 회화] 출입국관리소	immigration	일상 회화	immigration.webp
[비즈니스 영어] 기본 표현	business_expressions_basic	비즈니스 영어	business.webp
[비즈니스 영어] 실전 표현	business_expressions_intermediate	비즈니스 영어	business.webp
[비즈니스 영어] 고급 표현	business_expressions_advanced	비즈니스 영어	business.webp
[비즈니스 영어] 이메일 표현	business_expressions_email	비즈니스 영어	business.webp
[Grimms 동화] THE GOLDEN BIRD	grimm_the_golden_bird	그림 형제 동화집	grimms.webp
[Grimms 동화] HANS IN LUCK	grimm_hans_in_luck	그림 형제 동화집	grimms.webp
[Grimms 동화] JORINDA AND JORINDEL	grimm_jorinda_and_jorindel	그림 형제 동화집	grimms.webp
[Grimms 동화] THE TRAVELLING MUSICIANS	grimm_the_travelling_musicians	그림 형제 동화집	grimms.webp
[Grimms 동화] OLD SULTAN	grimm_old_sultan	그림 형제 동화집	grimms.webp
"[Grimms 동화] THE STRAW, THE COAL, AND THE BEAN"	"grimm_the_straw,_the_coal,_and_the_bean"	그림 형제 동화집	grimms.webp
[Grimms 동화] BRIAR ROSE	grimm_briar_rose	그림 형제 동화집	grimms.webp
[Grimms 동화] THE DOG AND THE SPARROW	grimm_the_dog_and_the_sparrow	그림 형제 동화집	grimms.webp
[Grimms 동화] THE TWELVE DANCING PRINCESSES	grimm_the_twelve_dancing_princesses	그림 형제 동화집	grimms.webp
[Grimms 동화] THE FISHERMAN AND HIS WIFE	grimm_the_fisherman_and_his_wife	그림 형제 동화집	grimms.webp
[Grimms 동화] THE WILLOW-WREN AND THE BEAR	grimm_the_willow-wren_and_the_bear	그림 형제 동화집	grimms.webp
[Grimms 동화] THE FROG-PRINCE	grimm_the_frog-prince	그림 형제 동화집	grimms.webp
[Grimms 동화] CAT AND MOUSE IN PARTNERSHIP	grimm_cat_and_mouse_in_partnership	그림 형제 동화집	grimms.webp
[Grimms 동화] THE GOOSE-GIRL	grimm_the_goose-girl	그림 형제 동화집	grimms.webp
[Grimms 동화] THE ADVENTURES OF CHANTICLEER AND PARTLET	grimm_the_adventures_of_chanticleer_and_partlet	그림 형제 동화집	grimms.webp
[Grimms 동화] RAPUNZEL	grimm_rapunzel	그림 형제 동화집	grimms.webp
[Grimms 동화] FUNDEVOGEL	grimm_fundevogel	그림 형제 동화집	grimms.webp
[Grimms 동화] THE VALIANT LITTLE TAILOR	grimm_the_valiant_little_tailor	그림 형제 동화집	grimms.webp
[Grimms 동화] HANSEL AND GRETEL	grimm_hansel_and_gretel	그림 형제 동화집	grimms.webp
[Grimms 동화] THE MOUSE, THE BIRD, AND THE SAUSAGE	grimm_the_mouse,_the_bird,_and_the_sausage	그림 형제 동화집	grimms.webp
[Grimms 동화] MOTHER HOLLE	grimm_mother_holle	그림 형제 동화집	grimms.webp
[Grimms 동화] LITTLE RED-CAP	grimm_little_red-cap	그림 형제 동화집	grimms.webp
[Grimms 동화] THE ROBBER BRIDEGROOM	grimm_the_robber_bridegroom	그림 형제 동화집	grimms.webp
[Grimms 동화] TOM THUMB	grimm_tom_thumb	그림 형제 동화집	grimms.webp
[Grimms 동화] RUMPELSTILTSKIN	grimm_rumpelstiltskin	그림 형제 동화집	grimms.webp
[Grimms 동화] CLEVER GRETEL	grimm_clever_gretel	그림 형제 동화집	grimms.webp
[Grimms 동화] THE OLD MAN AND HIS GRANDSON	grimm_the_old_man_and_his_grandson	그림 형제 동화집	grimms.webp
[Grimms 동화] THE LITTLE PEASANT	grimm_the_little_peasant	그림 형제 동화집	grimms.webp
[Grimms 동화] FREDERICK AND CATHERINE	grimm_frederick_and_catherine	그림 형제 동화집	grimms.webp
[Grimms 동화] SWEETHEART ROLAND	grimm_sweetheart_roland	그림 형제 동화집	grimms.webp
[Grimms 동화] SNOWDROP	grimm_snowdrop	그림 형제 동화집	grimms.webp
[Grimms 동화] THE PINK	grimm_the_pink	그림 형제 동화집	grimms.webp
[Grimms 동화] CLEVER ELSIE	grimm_clever_elsie	그림 형제 동화집	grimms.webp
[Grimms 동화] THE MISER IN THE BUSH	grimm_the_miser_in_the_bush	그림 형제 동화집	grimms.webp
[Grimms 동화] ASHPUTTEL	grimm_ashputtel	그림 형제 동화집	grimms.webp
[Grimms 동화] THE WHITE SNAKE	grimm_the_white_snake	그림 형제 동화집	grimms.webp
[Grimms 동화] THE WOLF AND THE SEVEN LITTLE KIDS	grimm_the_wolf_and_the_seven_little_kids	그림 형제 동화집	grimms.webp
[Grimms 동화] THE QUEEN BEE	grimm_the_queen_bee	그림 형제 동화집	grimms.webp
[Grimms 동화] THE ELVES AND THE SHOEMAKER	grimm_the_elves_and_the_shoemaker	그림 형제 동화집	grimms.webp
[Grimms 동화] THE JUNIPER-TREE	grimm_the_juniper-tree	그림 형제 동화집	grimms.webp
[Grimms 동화] THE TURNIP	grimm_the_turnip	그림 형제 동화집	grimms.webp
[Grimms 동화] CLEVER HANS	grimm_clever_hans	그림 형제 동화집	grimms.webp
[Grimms 동화] THE THREE LANGUAGES	grimm_the_three_languages	그림 형제 동화집	grimms.webp
[Grimms 동화] THE FOX AND THE CAT	grimm_the_fox_and_the_cat	그림 형제 동화집	grimms.webp
[Grimms 동화] THE FOUR CLEVER BROTHERS	grimm_the_four_clever_brothers	그림 형제 동화집	grimms.webp
[Grimms 동화] LILY AND THE LION	grimm_lily_and_the_lion	그림 형제 동화집	grimms.webp
[Grimms 동화] THE FOX AND THE HORSE	grimm_the_fox_and_the_horse	그림 형제 동화집	grimms.webp
[Grimms 동화] THE BLUE LIGHT	grimm_the_blue_light	그림 형제 동화집	grimms.webp
[Grimms 동화] THE RAVEN	grimm_the_raven	그림 형제 동화집	grimms.webp
[Grimms 동화] THE GOLDEN GOOSE	grimm_the_golden_goose	그림 형제 동화집	grimms.webp
[Grimms 동화] THE WATER OF LIFE	grimm_the_water_of_life	그림 형제 동화집	grimms.webp
[Grimms 동화] THE TWELVE HUNTSMEN	grimm_the_twelve_huntsmen	그림 형제 동화집	grimms.webp
[Grimms 동화] THE KING OF THE GOLDEN MOUNTAIN	grimm_the_king_of_the_golden_mountain	그림 형제 동화집	grimms.webp
[Grimms 동화] DOCTOR KNOWALL	grimm_doctor_knowall	그림 형제 동화집	grimms.webp
[Grimms 동화] THE SEVEN RAVENS	grimm_the_seven_ravens	그림 형제 동화집	grimms.webp
[Grimms 동화] THE WEDDING OF MRS FOX	grimm_the_wedding_of_mrs_fox	그림 형제 동화집	grimms.webp
[Grimms 동화] THE SALAD	grimm_the_salad	그림 형제 동화집	grimms.webp
[Grimms 동화] THE STORY OF THE YOUTH WHO WENT FORTH TO LEARN WHAT FEAR WAS	grimm_the_story_of_the_youth_who_went_forth_to_learn_what_fear_was	그림 형제 동화집	grimms.webp
[Grimms 동화] KING GRISLY-BEARD	grimm_king_grisly-beard	그림 형제 동화집	grimms.webp
[Grimms 동화] IRON HANS	grimm_iron_hans	그림 형제 동화집	grimms.webp
[Grimms 동화] CAT-SKIN	grimm_cat-skin	그림 형제 동화집	grimms.webp
[Grimms 동화] SNOW-WHITE AND ROSE-RED	grimm_snow-white_and_rose-red	그림 형제 동화집	grimms.webp
